=====================================================================
Kreirao: Nenad Radulović

Izmena : 
		a: 13.02.2011, Nenad
			Kreiranje dokumenta
=====================================================================

Imena SPICE biblioteka se sastoje od skraćenica proizvođača, a zatim i tip komponenti koja biblioteka opisuje.

Skraćenice korišćene u punim nazivima proizvođača:
    Inc - Incorporated
    Intl - International
    Tech - Technology
    Corp - Corporation
    Semicond - Semiconductor

Skraćeni nazivi proizvođača (izvor NYSE ili NASDAQ):
    TXN - Texas Instruments Inc.
    ADI - Analog Devices Inc.
    MXIM - Maxim Integrated Products
    BRCM - Broadcom Corp.
    ISIL - Intersil Corp.
    NSM - National Semicond. Corp.
    ONNN - ON Semicond. Corp.
    LLTC - Linear Technology Corp.
    QCOM - QUALCOMM Inc.
    ATML - Atmel Corp.
    STM - STMicroelectronics
    INTC - Intel Corp.
    NVDA - NVIDIA Corp.
    ATHR - Atheros Communications
    BRCM - Broadcom Corp.
    FCS - Fairchild Semicond.
    IRF - Intl. Rectifier Corp.
    NXPI - NXP Semicond.
    IFNNY - Infineon Tech. AG
    DIOD - Diodes Inc.
    VSH - Vishay Intertechnology
    AVX - AVX Corp.
    CNXT - Conexant Systems
    ZRAN - Zoran Corp.
    ALTR - Altera Corp.
    XLNX - Xilinx Inc.
    MCHP - Microchip Tech. Inc.
    CRUS - Cirrus Logic
    SLAB - Silicon Laboratories (SiLabs)
    TSE - Toshiba
    SANNY - Sanyo

Tip komponenti:
    BJT - Bipolar junction transistor
    IC - Integrated circuit
    D - Diode
